{
  "player": {
    "x": 6.04479065238559,
    "y": 13.951557093425604,
    "sx": 1.8,
    "sy": 2.7
  },
  "door": { "x": 30.000000000000004, "y": 6 },
  "obstacles": [
    { "x": 0, "y": 16, "sx": 32, "sy": 2, "type": 0 },
    { "x": 0, "y": 0, "sx": 2, "sy": 16, "type": 0 },
    { "x": 2, "y": 0, "sx": 30, "sy": 2, "type": 0 },
    { "x": 17, "y": 13, "sx": 6, "sy": 3, "type": 0 },
    { "x": 30, "y": 2, "sx": 1, "sy": 4, "type": 0 },
    { "x": 31, "y": 2, "sx": 1, "sy": 9, "type": 0 },
    { "x": 26, "y": 2, "sx": 4, "sy": 9, "type": 0 }
  ],
  "unstatics": [
    { "x": 18.999999999999996, "y": 12, "sx": 2, "sy": 2, "rest": 0, "type": 1 }
  ],
  "targets": [],
  "triggers": [
    { "x": 13, "y": 15.999999999999998, "sx": 0, "sy": 0, "type": 3 }
  ],
  "loadTriggers": [{ "x": 33, "y": 16, "sx": 1, "sy": 7, "type": 5 }],
  "obstacleTiles": [
    { "nr": 1, "x": 2, "y": 116 },
    { "nr": 1, "x": 3, "y": 116 },
    { "nr": 1, "x": 4, "y": 116 },
    { "nr": 1, "x": 5, "y": 116 },
    { "nr": 1, "x": 6, "y": 116 },
    { "nr": 1, "x": 7, "y": 116 },
    { "nr": 1, "x": 8, "y": 116 },
    { "nr": 1, "x": 9, "y": 116 },
    { "nr": 1, "x": 10, "y": 116 },
    { "nr": 1, "x": 11, "y": 116 },
    { "nr": 1, "x": 12, "y": 116 },
    { "nr": 1, "x": 13, "y": 116 },
    { "nr": 1, "x": 14, "y": 116 },
    { "nr": 1, "x": 15, "y": 116 },
    { "nr": 5, "x": 1, "y": 115 },
    { "nr": 5, "x": 1, "y": 114 },
    { "nr": 5, "x": 1, "y": 113 },
    { "nr": 5, "x": 1, "y": 112 },
    { "nr": 5, "x": 1, "y": 111 },
    { "nr": 5, "x": 1, "y": 110 },
    { "nr": 5, "x": 1, "y": 109 },
    { "nr": 5, "x": 1, "y": 108 },
    { "nr": 5, "x": 1, "y": 107 },
    { "nr": 5, "x": 1, "y": 106 },
    { "nr": 5, "x": 1, "y": 105 },
    { "nr": 5, "x": 1, "y": 104 },
    { "nr": 5, "x": 1, "y": 103 },
    { "nr": 5, "x": 1, "y": 102 },
    { "nr": 7, "x": 2, "y": 101 },
    { "nr": 7, "x": 3, "y": 101 },
    { "nr": 7, "x": 4, "y": 101 },
    { "nr": 7, "x": 5, "y": 101 },
    { "nr": 7, "x": 6, "y": 101 },
    { "nr": 7, "x": 7, "y": 101 },
    { "nr": 7, "x": 8, "y": 101 },
    { "nr": 7, "x": 9, "y": 101 },
    { "nr": 7, "x": 10, "y": 101 },
    { "nr": 7, "x": 11, "y": 101 },
    { "nr": 7, "x": 12, "y": 101 },
    { "nr": 7, "x": 13, "y": 101 },
    { "nr": 7, "x": 14, "y": 101 },
    { "nr": 7, "x": 15, "y": 101 },
    { "nr": 7, "x": 16, "y": 101 },
    { "nr": 7, "x": 17, "y": 101 },
    { "nr": 7, "x": 18, "y": 101 },
    { "nr": 7, "x": 19, "y": 101 },
    { "nr": 7, "x": 20, "y": 101 },
    { "nr": 7, "x": 21, "y": 101 },
    { "nr": 7, "x": 22, "y": 101 },
    { "nr": 7, "x": 23, "y": 101 },
    { "nr": 7, "x": 24, "y": 101 },
    { "nr": 11, "x": 1, "y": 116 },
    { "nr": 9, "x": 1, "y": 101 },
    { "nr": 4, "x": 31, "y": 100 },
    { "nr": 4, "x": 30, "y": 100 },
    { "nr": 4, "x": 29, "y": 100 },
    { "nr": 4, "x": 28, "y": 100 },
    { "nr": 4, "x": 27, "y": 100 },
    { "nr": 4, "x": 26, "y": 100 },
    { "nr": 4, "x": 25, "y": 100 },
    { "nr": 4, "x": 24, "y": 100 },
    { "nr": 4, "x": 23, "y": 100 },
    { "nr": 4, "x": 22, "y": 100 },
    { "nr": 4, "x": 21, "y": 100 },
    { "nr": 4, "x": 20, "y": 100 },
    { "nr": 4, "x": 19, "y": 100 },
    { "nr": 4, "x": 18, "y": 100 },
    { "nr": 4, "x": 17, "y": 100 },
    { "nr": 4, "x": 16, "y": 100 },
    { "nr": 4, "x": 15, "y": 100 },
    { "nr": 4, "x": 14, "y": 100 },
    { "nr": 4, "x": 13, "y": 100 },
    { "nr": 4, "x": 12, "y": 100 },
    { "nr": 4, "x": 11, "y": 100 },
    { "nr": 4, "x": 10, "y": 100 },
    { "nr": 4, "x": 9, "y": 100 },
    { "nr": 4, "x": 8, "y": 100 },
    { "nr": 4, "x": 7, "y": 100 },
    { "nr": 4, "x": 6, "y": 100 },
    { "nr": 4, "x": 5, "y": 100 },
    { "nr": 4, "x": 4, "y": 100 },
    { "nr": 4, "x": 3, "y": 100 },
    { "nr": 4, "x": 2, "y": 100 },
    { "nr": 4, "x": 1, "y": 100 },
    { "nr": 4, "x": 0, "y": 100 },
    { "nr": 4, "x": 0, "y": 101 },
    { "nr": 4, "x": 0, "y": 102 },
    { "nr": 4, "x": 0, "y": 103 },
    { "nr": 4, "x": 0, "y": 104 },
    { "nr": 4, "x": 0, "y": 105 },
    { "nr": 4, "x": 0, "y": 106 },
    { "nr": 4, "x": 0, "y": 107 },
    { "nr": 4, "x": 0, "y": 108 },
    { "nr": 4, "x": 0, "y": 109 },
    { "nr": 4, "x": 0, "y": 110 },
    { "nr": 4, "x": 0, "y": 111 },
    { "nr": 4, "x": 0, "y": 112 },
    { "nr": 4, "x": 0, "y": 113 },
    { "nr": 4, "x": 0, "y": 114 },
    { "nr": 4, "x": 0, "y": 115 },
    { "nr": 4, "x": 0, "y": 116 },
    { "nr": 4, "x": 0, "y": 117 },
    { "nr": 4, "x": 1, "y": 117 },
    { "nr": 4, "x": 2, "y": 117 },
    { "nr": 4, "x": 3, "y": 117 },
    { "nr": 4, "x": 4, "y": 117 },
    { "nr": 4, "x": 5, "y": 117 },
    { "nr": 4, "x": 6, "y": 117 },
    { "nr": 4, "x": 7, "y": 117 },
    { "nr": 4, "x": 8, "y": 117 },
    { "nr": 4, "x": 9, "y": 117 },
    { "nr": 4, "x": 10, "y": 117 },
    { "nr": 4, "x": 11, "y": 117 },
    { "nr": 4, "x": 12, "y": 117 },
    { "nr": 4, "x": 13, "y": 117 },
    { "nr": 4, "x": 14, "y": 117 },
    { "nr": 4, "x": 15, "y": 117 },
    { "nr": 4, "x": 16, "y": 117 },
    { "nr": 4, "x": 17, "y": 117 },
    { "nr": 4, "x": 18, "y": 117 },
    { "nr": 4, "x": 19, "y": 117 },
    { "nr": 4, "x": 20, "y": 117 },
    { "nr": 4, "x": 21, "y": 117 },
    { "nr": 4, "x": 22, "y": 117 },
    { "nr": 4, "x": 23, "y": 117 },
    { "nr": 4, "x": 24, "y": 117 },
    { "nr": 4, "x": 25, "y": 117 },
    { "nr": 4, "x": 26, "y": 117 },
    { "nr": 4, "x": 27, "y": 117 },
    { "nr": 4, "x": 28, "y": 117 },
    { "nr": 4, "x": 29, "y": 117 },
    { "nr": 4, "x": 30, "y": 117 },
    { "nr": 4, "x": 31, "y": 117 },
    { "nr": 4, "x": 31, "y": 101 },
    { "nr": 1, "x": 16, "y": 116 },
    { "nr": 4, "x": 27, "y": 101 },
    { "nr": 4, "x": 28, "y": 101 },
    { "nr": 4, "x": 29, "y": 101 },
    { "nr": 4, "x": 30, "y": 101 },
    { "nr": 4, "x": 28, "y": 105 },
    { "nr": 4, "x": 27, "y": 105 },
    { "nr": 4, "x": 27, "y": 102 },
    { "nr": 4, "x": 28, "y": 102 },
    { "nr": 4, "x": 29, "y": 102 },
    { "nr": 4, "x": 29, "y": 103 },
    { "nr": 4, "x": 28, "y": 103 },
    { "nr": 4, "x": 27, "y": 103 },
    { "nr": 4, "x": 27, "y": 104 },
    { "nr": 4, "x": 28, "y": 104 },
    { "nr": 4, "x": 29, "y": 104 },
    { "nr": 7, "x": 25, "y": 101 },
    { "nr": 3, "x": 26, "y": 102 },
    { "nr": 3, "x": 26, "y": 103 },
    { "nr": 3, "x": 26, "y": 104 },
    { "nr": 3, "x": 26, "y": 105 },
    { "nr": 3, "x": 26, "y": 106 },
    { "nr": 3, "x": 26, "y": 107 },
    { "nr": 3, "x": 26, "y": 108 },
    { "nr": 3, "x": 26, "y": 109 },
    { "nr": 7, "x": 27, "y": 110 },
    { "nr": 7, "x": 28, "y": 110 },
    { "nr": 4, "x": 31, "y": 104 },
    { "nr": 4, "x": 31, "y": 103 },
    { "nr": 4, "x": 31, "y": 102 },
    { "nr": 4, "x": 30, "y": 102 },
    { "nr": 4, "x": 30, "y": 103 },
    { "nr": 4, "x": 30, "y": 104 },
    { "nr": 10, "x": 26, "y": 101 },
    { "nr": 6, "x": 26, "y": 110 },
    { "nr": 4, "x": 27, "y": 106 },
    { "nr": 4, "x": 28, "y": 106 },
    { "nr": 4, "x": 28, "y": 107 },
    { "nr": 4, "x": 27, "y": 107 },
    { "nr": 4, "x": 27, "y": 108 },
    { "nr": 4, "x": 28, "y": 108 },
    { "nr": 4, "x": 28, "y": 109 },
    { "nr": 4, "x": 27, "y": 109 },
    { "nr": 1, "x": 23, "y": 116 },
    { "nr": 1, "x": 24, "y": 116 },
    { "nr": 1, "x": 25, "y": 116 },
    { "nr": 1, "x": 26, "y": 116 },
    { "nr": 1, "x": 27, "y": 116 },
    { "nr": 1, "x": 28, "y": 116 },
    { "nr": 1, "x": 29, "y": 116 },
    { "nr": 1, "x": 30, "y": 116 },
    { "nr": 1, "x": 31, "y": 116 },
    { "nr": 1, "x": 37, "y": 114 },
    { "nr": 1, "x": 18, "y": 113 },
    { "nr": 1, "x": 19, "y": 113 },
    { "nr": 1, "x": 20, "y": 113 },
    { "nr": 1, "x": 21, "y": 113 },
    { "nr": 2, "x": 22, "y": 113 },
    { "nr": 0, "x": 17, "y": 113 },
    { "nr": 3, "x": 17, "y": 114 },
    { "nr": 3, "x": 17, "y": 115 },
    { "nr": 5, "x": 22, "y": 114 },
    { "nr": 5, "x": 22, "y": 115 },
    { "nr": 4, "x": 18, "y": 114 },
    { "nr": 4, "x": 18, "y": 115 },
    { "nr": 4, "x": 18, "y": 116 },
    { "nr": 4, "x": 19, "y": 116 },
    { "nr": 4, "x": 20, "y": 116 },
    { "nr": 4, "x": 21, "y": 116 },
    { "nr": 4, "x": 21, "y": 115 },
    { "nr": 4, "x": 21, "y": 114 },
    { "nr": 4, "x": 20, "y": 114 },
    { "nr": 4, "x": 19, "y": 114 },
    { "nr": 4, "x": 19, "y": 115 },
    { "nr": 4, "x": 20, "y": 115 },
    { "nr": 12, "x": 17, "y": 116 },
    { "nr": 11, "x": 22, "y": 116 },
    { "nr": 8, "x": 29, "y": 110 },
    { "nr": 5, "x": 29, "y": 109 },
    { "nr": 5, "x": 29, "y": 108 },
    { "nr": 5, "x": 29, "y": 107 },
    { "nr": 5, "x": 29, "y": 106 },
    { "nr": 9, "x": 29, "y": 105 },
    { "nr": 7, "x": 30, "y": 105 },
    { "nr": 10, "x": 31, "y": 105 },
    { "nr": 3, "x": 31, "y": 106 },
    { "nr": 3, "x": 31, "y": 107 },
    { "nr": 3, "x": 31, "y": 108 },
    { "nr": 3, "x": 31, "y": 109 },
    { "nr": 6, "x": 31, "y": 110 },
    { "nr": 1, "x": 32, "y": 116 },
    { "nr": 7, "x": 32, "y": 110 },
    { "nr": 4, "x": 32, "y": 109 },
    { "nr": 4, "x": 32, "y": 108 },
    { "nr": 4, "x": 32, "y": 107 },
    { "nr": 4, "x": 32, "y": 106 },
    { "nr": 4, "x": 32, "y": 105 },
    { "nr": 4, "x": 32, "y": 104 },
    { "nr": 4, "x": 32, "y": 103 },
    { "nr": 4, "x": 32, "y": 102 },
    { "nr": 4, "x": 32, "y": 101 },
    { "nr": 4, "x": 32, "y": 100 },
    { "nr": 4, "x": 32, "y": 117 }
  ],
  "targetTiles": [],
  "lavaTiles": [],
  "soundtrack": "Try and Solve This Loop.wav"
}
